11111111111111111111
1CCCCCCCCCCCCCCCCCC1
1CE010110000111100C1
1C0010110000001100C1
1C0011111100110000C1
1C000011000011110PC1
1CCCCCCCCCCCCCCCCCC1
11111111111111111111