1111111111111111111111111
10010000001110C00000011E1
1001111000001000000000101
1P0100000110000011100C001
11000110001100001C1000001
1111111111111111111111111