11111111
1P0000P1
100C00E1
11111111